"filename", "language", "Lua", "JSON", "Markdown", "Log", "comment", "blank", "total"
"c:\Users\haoti\Documents\GitHub\blockgamev2\README.md", "Markdown", 0, 0, 12, 0, 0, 5, 17
"c:\Users\haoti\Documents\GitHub\blockgamev2\default.project.json", "JSON", 0, 48, 0, 0, 0, 0, 48
"c:\Users\haoti\Documents\GitHub\blockgamev2\rbxlx-to-rojo.log", "Log", 0, 0, 0, 2, 0, 1, 3
"c:\Users\haoti\Documents\GitHub\blockgamev2\src\ReplicatedStorage\AnimationController.lua", "Lua", 72, 0, 0, 0, 0, 0, 72
"c:\Users\haoti\Documents\GitHub\blockgamev2\src\ReplicatedStorage\BehaviorHandler.lua", "Lua", 140, 0, 0, 0, 1, 0, 141
"c:\Users\haoti\Documents\GitHub\blockgamev2\src\ReplicatedStorage\BehaviorPacks\Cubic\Behaviors.lua", "Lua", 79, 0, 0, 0, 1, 0, 80
"c:\Users\haoti\Documents\GitHub\blockgamev2\src\ReplicatedStorage\BehaviorPacks\Cubic\BlockHitboxes\init.lua", "Lua", 21, 0, 0, 0, 0, 0, 21
"c:\Users\haoti\Documents\GitHub\blockgamev2\src\ReplicatedStorage\BehaviorPacks\Cubic\Blocks\init.lua", "Lua", 85, 0, 0, 0, 0, 13, 98
"c:\Users\haoti\Documents\GitHub\blockgamev2\src\ReplicatedStorage\BehaviorPacks\Cubic\Components.lua", "Lua", 24, 0, 0, 0, 0, 2, 26
"c:\Users\haoti\Documents\GitHub\blockgamev2\src\ReplicatedStorage\BehaviorPacks\Cubic\Crafting\init.lua", "Lua", 50, 0, 0, 0, 0, 6, 56
"c:\Users\haoti\Documents\GitHub\blockgamev2\src\ReplicatedStorage\BehaviorPacks\Cubic\Entities\Npc.lua", "Lua", 44, 0, 0, 0, 8, 2, 54
"c:\Users\haoti\Documents\GitHub\blockgamev2\src\ReplicatedStorage\BehaviorPacks\Cubic\Entities\Player.lua", "Lua", 34, 0, 0, 0, 0, 4, 38
"c:\Users\haoti\Documents\GitHub\blockgamev2\src\ReplicatedStorage\BehaviorPacks\Cubic\Entities\init.lua", "Lua", 28, 0, 0, 0, 0, 5, 33
"c:\Users\haoti\Documents\GitHub\blockgamev2\src\ReplicatedStorage\BehaviorPacks\Cubic\Functions.lua", "Lua", 162, 0, 0, 0, 1, 3, 166
"c:\Users\haoti\Documents\GitHub\blockgamev2\src\ReplicatedStorage\BehaviorPacks\Cubic\Info.lua", "Lua", 2, 0, 0, 0, 0, 0, 2
"c:\Users\haoti\Documents\GitHub\blockgamev2\src\ReplicatedStorage\BehaviorPacks\Cubic\ItemTypes.lua", "Lua", 52, 0, 0, 0, 2, 3, 57
"c:\Users\haoti\Documents\GitHub\blockgamev2\src\ReplicatedStorage\BehaviorPacks\Cubic\Items\init.lua", "Lua", 65, 0, 0, 0, 1, 6, 72
"c:\Users\haoti\Documents\GitHub\blockgamev2\src\ReplicatedStorage\BehaviorPacks\Cubic\Server.lua", "Lua", 36, 0, 0, 0, 1, 2, 39
"c:\Users\haoti\Documents\GitHub\blockgamev2\src\ReplicatedStorage\BridgeNet\Bridge.lua", "Lua", 16, 0, 0, 0, 0, 1, 17
"c:\Users\haoti\Documents\GitHub\blockgamev2\src\ReplicatedStorage\BridgeNet\ClientBridge.lua", "Lua", 351, 0, 0, 0, 12, 87, 450
"c:\Users\haoti\Documents\GitHub\blockgamev2\src\ReplicatedStorage\BridgeNet\CreateBridgeTree.lua", "Lua", 34, 0, 0, 0, 1, 8, 43
"c:\Users\haoti\Documents\GitHub\blockgamev2\src\ReplicatedStorage\BridgeNet\SerdesLayer.lua", "Lua", 165, 0, 0, 0, 8, 47, 220
"c:\Users\haoti\Documents\GitHub\blockgamev2\src\ReplicatedStorage\BridgeNet\ServerBridge.lua", "Lua", 636, 0, 0, 0, 24, 125, 785
"c:\Users\haoti\Documents\GitHub\blockgamev2\src\ReplicatedStorage\BridgeNet\init.lua", "Lua", 105, 0, 0, 0, 4, 27, 136
"c:\Users\haoti\Documents\GitHub\blockgamev2\src\ReplicatedStorage\CHUNKOLD.lua", "Lua", 133, 0, 0, 0, 8, 1, 142
"c:\Users\haoti\Documents\GitHub\blockgamev2\src\ReplicatedStorage\Chunk.lua", "Lua", 163, 0, 0, 0, 0, 4, 167
"c:\Users\haoti\Documents\GitHub\blockgamev2\src\ReplicatedStorage\CollisonHandler.lua", "Lua", 666, 0, 0, 0, 54, 22, 742
"c:\Users\haoti\Documents\GitHub\blockgamev2\src\ReplicatedStorage\DataHandler\DoFunc.model.json", "JSON", 0, 3, 0, 0, 0, 1, 4
"c:\Users\haoti\Documents\GitHub\blockgamev2\src\ReplicatedStorage\DataHandler\init.lua", "Lua", 142, 0, 0, 0, 5, 3, 150
"c:\Users\haoti\Documents\GitHub\blockgamev2\src\ReplicatedStorage\EntityHandler.lua", "Lua", 1014, 0, 0, 0, 46, 8, 1068
"c:\Users\haoti\Documents\GitHub\blockgamev2\src\ReplicatedStorage\EntityMovers\Curve.lua", "Lua", 80, 0, 0, 0, 7, 1, 88
"c:\Users\haoti\Documents\GitHub\blockgamev2\src\ReplicatedStorage\EntityMovers\MoveTo.lua", "Lua", 58, 0, 0, 0, 2, 0, 60
"c:\Users\haoti\Documents\GitHub\blockgamev2\src\ReplicatedStorage\EntityMovers\init.lua", "Lua", 5, 0, 0, 0, 0, 0, 5
"c:\Users\haoti\Documents\GitHub\blockgamev2\src\ReplicatedStorage\Events\DoSmt.model.json", "JSON", 0, 3, 0, 0, 0, 1, 4
"c:\Users\haoti\Documents\GitHub\blockgamev2\src\ReplicatedStorage\Events\EntityUpdater.model.json", "JSON", 0, 3, 0, 0, 0, 1, 4
"c:\Users\haoti\Documents\GitHub\blockgamev2\src\ReplicatedStorage\Events\GetChunk.model.json", "JSON", 0, 3, 0, 0, 0, 1, 4
"c:\Users\haoti\Documents\GitHub\blockgamev2\src\ReplicatedStorage\Events\KB.model.json", "JSON", 0, 3, 0, 0, 0, 1, 4
"c:\Users\haoti\Documents\GitHub\blockgamev2\src\ReplicatedStorage\Events\OnDeath.model.json", "JSON", 0, 3, 0, 0, 0, 1, 4
"c:\Users\haoti\Documents\GitHub\blockgamev2\src\ReplicatedStorage\Events\Respawn.model.json", "JSON", 0, 3, 0, 0, 0, 1, 4
"c:\Users\haoti\Documents\GitHub\blockgamev2\src\ReplicatedStorage\Events\SendEntities.model.json", "JSON", 0, 3, 0, 0, 0, 1, 4
"c:\Users\haoti\Documents\GitHub\blockgamev2\src\ReplicatedStorage\Events\ServerFPS.model.json", "JSON", 0, 3, 0, 0, 0, 1, 4
"c:\Users\haoti\Documents\GitHub\blockgamev2\src\ReplicatedStorage\GameSettings.lua", "Lua", 14, 0, 0, 0, 0, 0, 14
"c:\Users\haoti\Documents\GitHub\blockgamev2\src\ReplicatedStorage\ItemHandler.lua", "Lua", 94, 0, 0, 0, 0, 1, 95
"c:\Users\haoti\Documents\GitHub\blockgamev2\src\ReplicatedStorage\Libarys\Bezier.lua", "Lua", 168, 0, 0, 0, 49, 87, 304
"c:\Users\haoti\Documents\GitHub\blockgamev2\src\ReplicatedStorage\Libarys\BlockStore.lua", "Lua", 55, 0, 0, 0, 0, 0, 55
"c:\Users\haoti\Documents\GitHub\blockgamev2\src\ReplicatedStorage\Libarys\Debris.lua", "Lua", 49, 0, 0, 0, 0, 0, 49
"c:\Users\haoti\Documents\GitHub\blockgamev2\src\ReplicatedStorage\Libarys\Debugger.lua", "Lua", 25, 0, 0, 0, 9, 0, 34
"c:\Users\haoti\Documents\GitHub\blockgamev2\src\ReplicatedStorage\Libarys\DelayHandler.lua", "Lua", 47, 0, 0, 0, 0, 1, 48
"c:\Users\haoti\Documents\GitHub\blockgamev2\src\ReplicatedStorage\Libarys\EntityAttribute.lua", "Lua", 90, 0, 0, 0, 0, 1, 91
"c:\Users\haoti\Documents\GitHub\blockgamev2\src\ReplicatedStorage\Libarys\GlobalDebris.lua", "Lua", 61, 0, 0, 0, 0, 2, 63
"c:\Users\haoti\Documents\GitHub\blockgamev2\src\ReplicatedStorage\Libarys\Grid.lua", "Lua", 22, 0, 0, 0, 0, 1, 23
"c:\Users\haoti\Documents\GitHub\blockgamev2\src\ReplicatedStorage\Libarys\MathFunctions.lua", "Lua", 111, 0, 0, 0, 2, 2, 115
"c:\Users\haoti\Documents\GitHub\blockgamev2\src\ReplicatedStorage\Libarys\ModingRemote\init.lua", "Lua", 56, 0, 0, 0, 0, 1, 57
"c:\Users\haoti\Documents\GitHub\blockgamev2\src\ReplicatedStorage\Libarys\PlayerControls.lua", "Lua", 63, 0, 0, 0, 0, 5, 68
"c:\Users\haoti\Documents\GitHub\blockgamev2\src\ReplicatedStorage\Libarys\Signal.lua", "Lua", 58, 0, 0, 0, 1, 17, 76
"c:\Users\haoti\Documents\GitHub\blockgamev2\src\ReplicatedStorage\Libarys\compressor.lua", "Lua", 169, 0, 0, 0, 2, 12, 183
"c:\Users\haoti\Documents\GitHub\blockgamev2\src\ReplicatedStorage\Libarys\lualzw.lua", "Lua", 146, 0, 0, 0, 1, 18, 165
"c:\Users\haoti\Documents\GitHub\blockgamev2\src\ReplicatedStorage\Managers\ArmsManager.lua", "Lua", 175, 0, 0, 0, 1, 1, 177
"c:\Users\haoti\Documents\GitHub\blockgamev2\src\ReplicatedStorage\Managers\CraftingManager.lua", "Lua", 145, 0, 0, 0, 3, 3, 151
"c:\Users\haoti\Documents\GitHub\blockgamev2\src\ReplicatedStorage\Managers\HotBarManager.lua", "Lua", 68, 0, 0, 0, 0, 0, 68
"c:\Users\haoti\Documents\GitHub\blockgamev2\src\ReplicatedStorage\Managers\InventoryManager.lua", "Lua", 143, 0, 0, 0, 7, 3, 153
"c:\Users\haoti\Documents\GitHub\blockgamev2\src\ReplicatedStorage\Managers\PlayerDollHandler.lua", "Lua", 38, 0, 0, 0, 0, 1, 39
"c:\Users\haoti\Documents\GitHub\blockgamev2\src\ReplicatedStorage\Managers\UIContainerManager.lua", "Lua", 270, 0, 0, 0, 2, 7, 279
"c:\Users\haoti\Documents\GitHub\blockgamev2\src\ReplicatedStorage\Managers\init.lua", "Lua", 11, 0, 0, 0, 0, 0, 11
"c:\Users\haoti\Documents\GitHub\blockgamev2\src\ReplicatedStorage\ModHandler\init.lua", "Lua", 216, 0, 0, 0, 9, 28, 253
"c:\Users\haoti\Documents\GitHub\blockgamev2\src\ReplicatedStorage\MultiHandler\FunctionsToMultiThread.lua", "Lua", 134, 0, 0, 0, 2, 3, 139
"c:\Users\haoti\Documents\GitHub\blockgamev2\src\ReplicatedStorage\MultiHandler\GlobalMemory.lua", "Lua", 35, 0, 0, 0, 0, 1, 36
"c:\Users\haoti\Documents\GitHub\blockgamev2\src\ReplicatedStorage\MultiHandler\init.lua", "Lua", 222, 0, 0, 0, 17, 4, 243
"c:\Users\haoti\Documents\GitHub\blockgamev2\src\ReplicatedStorage\QuickFunctions\init.lua", "Lua", 469, 0, 0, 0, 15, 4, 488
"c:\Users\haoti\Documents\GitHub\blockgamev2\src\ReplicatedStorage\Ray.lua", "Lua", 97, 0, 0, 0, 1, 0, 98
"c:\Users\haoti\Documents\GitHub\blockgamev2\src\ReplicatedStorage\RenderStuff\Culling.lua", "Lua", 91, 0, 0, 0, 2, 2, 95
"c:\Users\haoti\Documents\GitHub\blockgamev2\src\ReplicatedStorage\RenderStuff\GreedyMesh.lua", "Lua", 215, 0, 0, 0, 6, 0, 221
"c:\Users\haoti\Documents\GitHub\blockgamev2\src\ReplicatedStorage\RenderStuff\GreedyMeshingHandler.lua", "Lua", 13, 0, 0, 0, 1, 12, 26
"c:\Users\haoti\Documents\GitHub\blockgamev2\src\ReplicatedStorage\RenderStuff\OLD Culling copy.lua", "Lua", 137, 0, 0, 0, 5, 2, 144
"c:\Users\haoti\Documents\GitHub\blockgamev2\src\ReplicatedStorage\RenderStuff\OldRender.lua", "Lua", 408, 0, 0, 0, 34, 6, 448
"c:\Users\haoti\Documents\GitHub\blockgamev2\src\ReplicatedStorage\RenderStuff\Render.lua", "Lua", 407, 0, 0, 0, 32, 7, 446
"c:\Users\haoti\Documents\GitHub\blockgamev2\src\ReplicatedStorage\ResourceHandler.lua", "Lua", 87, 0, 0, 0, 6, 2, 95
"c:\Users\haoti\Documents\GitHub\blockgamev2\src\ServerScriptService\__Init__.server.lua", "Lua", 190, 0, 0, 0, 14, 7, 211
"c:\Users\haoti\Documents\GitHub\blockgamev2\src\ServerStorage\DataStores\BlockSaver.lua", "Lua", 88, 0, 0, 0, 1, 0, 89
"c:\Users\haoti\Documents\GitHub\blockgamev2\src\ServerStorage\DataStores\init.lua", "Lua", 2, 0, 0, 0, 0, 1, 3
"c:\Users\haoti\Documents\GitHub\blockgamev2\src\ServerStorage\EntityAttributesCreator.lua", "Lua", 209, 0, 0, 0, 1, 2, 212
"c:\Users\haoti\Documents\GitHub\blockgamev2\src\ServerStorage\GenerationHandler\init.lua", "Lua", 164, 0, 0, 0, 17, 8, 189
"c:\Users\haoti\Documents\GitHub\blockgamev2\src\ServerStorage\LargeChunk.lua", "Lua", 54, 0, 0, 0, 0, 1, 55
"c:\Users\haoti\Documents\GitHub\blockgamev2\src\ServerStorage\PathFinding.lua", "Lua", 253, 0, 0, 0, 26, 13, 292
"c:\Users\haoti\Documents\GitHub\blockgamev2\src\ServerStorage\PlayerControlsHandler.lua", "Lua", 35, 0, 0, 0, 0, 2, 37
"c:\Users\haoti\Documents\GitHub\blockgamev2\src\ServerStorage\ServerStuff\DataHandler.lua", "Lua", 91, 0, 0, 0, 58, 3, 152
"c:\Users\haoti\Documents\GitHub\blockgamev2\src\ServerStorage\ServerStuff\EntityHandler.lua", "Lua", 305, 0, 0, 0, 3, 2, 310
"c:\Users\haoti\Documents\GitHub\blockgamev2\src\ServerStorage\ServerStuff\Old Chunk copy.lua", "Lua", 154, 0, 0, 0, 32, 7, 193
"c:\Users\haoti\Documents\GitHub\blockgamev2\src\ServerStorage\ServerStuff\ServerChunk.lua", "Lua", 138, 0, 0, 0, 0, 5, 143
"c:\Users\haoti\Documents\GitHub\blockgamev2\src\StarterPlayer\StarterPlayerScripts\Controller.lua", "Lua", 463, 0, 0, 0, 16, 7, 486
"c:\Users\haoti\Documents\GitHub\blockgamev2\src\StarterPlayer\StarterPlayerScripts\PlayerSettings.lua", "Lua", 0, 0, 0, 0, 0, 1, 1
"c:\Users\haoti\Documents\GitHub\blockgamev2\src\StarterPlayer\StarterPlayerScripts\__init__.client.lua", "Lua", 382, 0, 0, 0, 15, 6, 403
"c:\Users\haoti\Documents\GitHub\blockgamev2\src\Workspace\SimplexModule.lua", "Lua", 253, 0, 0, 0, 3, 58, 314
"Total", "-", 11852, 75, 12, 2, 579, 752, 13272