"filename", "language", "Lua", "JSON", "comment", "blank", "total"
"c:\Users\haoti\Documents\GitHub\blockgamev2\src\ReplicatedStorage\Chunk\init.lua", "Lua", 1, 0, 0, 0, 1
"c:\Users\haoti\Documents\GitHub\blockgamev2\src\ReplicatedStorage\Libarys\Signal.lua", "Lua", 1, 0, 0, -1, 0
"c:\Users\haoti\Documents\GitHub\blockgamev2\src\ReplicatedStorage\Utils\IndexUtils.lua", "Lua", 18, 0, 0, 1, 19
"c:\Users\haoti\Documents\GitHub\blockgamev2\src\ServerStorage\Generation\generation\biomes\layers\noise\NoiseLayer.lua", "Lua", -1, 0, 0, 0, -1
"c:\Users\haoti\Documents\GitHub\blockgamev2\src\ServerStorage\core\Chunk\GenerationLayer\airStoneLayer.lua", "Lua", 73, 0, 0, 3, 76
"c:\Users\haoti\Documents\GitHub\blockgamev2\src\ServerStorage\core\Chunk\GenerationLayer\biomeLayer.lua", "Lua", 9, 0, 0, 2, 11
"c:\Users\haoti\Documents\GitHub\blockgamev2\src\ServerStorage\core\Chunk\GenerationLayer\combineLayer.lua", "Lua", 17, 0, 0, 1, 18
"c:\Users\haoti\Documents\GitHub\blockgamev2\src\ServerStorage\core\Chunk\GenerationLayer\init.lua", "Lua", 52, 0, 0, 3, 55
"c:\Users\haoti\Documents\GitHub\blockgamev2\src\ServerStorage\core\Chunk\GenerationLayer\surfaceNoiseLayer.lua", "Lua", 9, 0, 0, 2, 11
"c:\Users\haoti\Documents\GitHub\blockgamev2\src\ServerStorage\core\Chunk\Generator\Actor\DataHandler.model.json", "JSON", 0, -3, 0, 0, -3
"c:\Users\haoti\Documents\GitHub\blockgamev2\src\ServerStorage\core\Chunk\Generator\GeneratorWorker.lua", "Lua", -63, 0, -4, -7, -74
"c:\Users\haoti\Documents\GitHub\blockgamev2\src\ServerStorage\core\Chunk\Generator\Tasks.lua", "Lua", 35, 0, 2, 0, 37
"c:\Users\haoti\Documents\GitHub\blockgamev2\src\ServerStorage\core\Chunk\Generator\init.lua", "Lua", 3, 0, 0, 0, 3
"c:\Users\haoti\Documents\GitHub\blockgamev2\src\ServerStorage\core\Chunk\OverworldStack.lua", "Lua", 7, 0, 0, 0, 7
"c:\Users\haoti\Documents\GitHub\blockgamev2\src\ServerStorage\core\Chunk\init.lua", "Lua", 42, 0, 0, 10, 52
"c:\Users\haoti\Documents\GitHub\blockgamev2\src\ServerStorage\core\Chunk\manager.lua", "Lua", -10, 0, 0, -2, -12
"c:\Users\haoti\Documents\GitHub\blockgamev2\src\StarterPlayer\StarterPlayerScripts\Render\Actor\Main.client.lua", "Lua", 12, 0, 0, 2, 14
"c:\Users\haoti\Documents\GitHub\blockgamev2\src\StarterPlayer\StarterPlayerScripts\Render\Actor\Main.meta.json", "JSON", 0, 5, 0, 0, 5
"c:\Users\haoti\Documents\GitHub\blockgamev2\src\StarterPlayer\StarterPlayerScripts\Render\Actor\init.meta.json", "JSON", 0, 3, 0, 0, 3
"c:\Users\haoti\Documents\GitHub\blockgamev2\src\StarterPlayer\StarterPlayerScripts\Render\ChunkCompressor.lua", "Lua", 0, 0, 0, 1, 1
"c:\Users\haoti\Documents\GitHub\blockgamev2\src\StarterPlayer\StarterPlayerScripts\Render\GreedyMesh.lua", "Lua", 182, 0, 1, 3, 186
"c:\Users\haoti\Documents\GitHub\blockgamev2\src\StarterPlayer\StarterPlayerScripts\Render\RenderWorker.lua", "Lua", 61, 0, 0, 6, 67
"c:\Users\haoti\Documents\GitHub\blockgamev2\src\StarterPlayer\StarterPlayerScripts\Render\Tasks.lua", "Lua", 110, 0, 1, 6, 117
"c:\Users\haoti\Documents\GitHub\blockgamev2\src\StarterPlayer\StarterPlayerScripts\Render\init.lua", "Lua", -16, 0, 0, 0, -16
"c:\Users\haoti\Documents\GitHub\blockgamev2\src\StarterPlayer\StarterPlayerScripts\__init__.client.lua", "Lua", 0, 0, 1, -1, 0
"c:\Users\haoti\Documents\GitHub\blockgamev2\src\StarterPlayer\StarterPlayerScripts\core\chunk\init.lua", "Lua", 63, 0, 0, 7, 70
"Total", "-", 605, 5, 1, 36, 647