"filename", "language", "JSON", "Lua", "comment", "blank", "total"
"c:\Users\haoti\Documents\GitHub\blockgamev2\sourcemap.json", "JSON", 1, 0, 0, 0, 1
"c:\Users\haoti\Documents\GitHub\blockgamev2\src\ReplicatedStorage\BehaviorHandler.lua", "Lua", 0, -184, -2, -1, -187
"c:\Users\haoti\Documents\GitHub\blockgamev2\src\ReplicatedStorage\BehaviorPacksV2\Cubic\BlockCollisionBoxes\init.lua", "Lua", 0, -1, 0, 1, 0
"c:\Users\haoti\Documents\GitHub\blockgamev2\src\ReplicatedStorage\BehaviorPacksV2\Cubic\Functions.lua", "Lua", 0, 0, 1, 0, 1
"c:\Users\haoti\Documents\GitHub\blockgamev2\src\ReplicatedStorage\BehaviorPacksV2\Cubic\Items\init.lua", "Lua", 0, -79, -1, -6, -86
"c:\Users\haoti\Documents\GitHub\blockgamev2\src\ReplicatedStorage\BehaviorPacks\Cubic\Behaviors.lua", "Lua", 0, -84, -1, 0, -85
"c:\Users\haoti\Documents\GitHub\blockgamev2\src\ReplicatedStorage\BehaviorPacks\Cubic\Biomes\init.lua", "Lua", 0, -16, 0, -1, -17
"c:\Users\haoti\Documents\GitHub\blockgamev2\src\ReplicatedStorage\BehaviorPacks\Cubic\BlockHitboxes\init.lua", "Lua", 0, -21, 0, 0, -21
"c:\Users\haoti\Documents\GitHub\blockgamev2\src\ReplicatedStorage\BehaviorPacks\Cubic\Blocks\init.lua", "Lua", 0, -133, -1, -19, -153
"c:\Users\haoti\Documents\GitHub\blockgamev2\src\ReplicatedStorage\BehaviorPacks\Cubic\Components.lua", "Lua", 0, -23, 0, -2, -25
"c:\Users\haoti\Documents\GitHub\blockgamev2\src\ReplicatedStorage\BehaviorPacks\Cubic\Crafting\init.lua", "Lua", 0, -50, 0, -6, -56
"c:\Users\haoti\Documents\GitHub\blockgamev2\src\ReplicatedStorage\BehaviorPacks\Cubic\Entities\Npc.lua", "Lua", 0, -54, 0, -2, -56
"c:\Users\haoti\Documents\GitHub\blockgamev2\src\ReplicatedStorage\BehaviorPacks\Cubic\Entities\Player.lua", "Lua", 0, -39, 0, -4, -43
"c:\Users\haoti\Documents\GitHub\blockgamev2\src\ReplicatedStorage\BehaviorPacks\Cubic\Entities\init.lua", "Lua", 0, -28, 0, -5, -33
"c:\Users\haoti\Documents\GitHub\blockgamev2\src\ReplicatedStorage\BehaviorPacks\Cubic\Features\init.lua", "Lua", 0, -70, -1, -2, -73
"c:\Users\haoti\Documents\GitHub\blockgamev2\src\ReplicatedStorage\BehaviorPacks\Cubic\Functions.lua", "Lua", 0, -198, -9, -3, -210
"c:\Users\haoti\Documents\GitHub\blockgamev2\src\ReplicatedStorage\BehaviorPacks\Cubic\Info.lua", "Lua", 0, -2, 0, 0, -2
"c:\Users\haoti\Documents\GitHub\blockgamev2\src\ReplicatedStorage\BehaviorPacks\Cubic\ItemTypes.lua", "Lua", 0, -52, -2, -3, -57
"c:\Users\haoti\Documents\GitHub\blockgamev2\src\ReplicatedStorage\BehaviorPacks\Cubic\Items\init.lua", "Lua", 0, -80, -1, -6, -87
"c:\Users\haoti\Documents\GitHub\blockgamev2\src\ReplicatedStorage\BehaviorPacks\Cubic\Server.lua", "Lua", 0, -37, -1, -2, -40
"c:\Users\haoti\Documents\GitHub\blockgamev2\src\ReplicatedStorage\BehaviorPacks\Cubic\WorldGeneration\c\density_function\overworld\CubicalSurface.lua", "Lua", 0, -17, 0, 0, -17
"c:\Users\haoti\Documents\GitHub\blockgamev2\src\ReplicatedStorage\BehaviorPacks\Cubic\WorldGeneration\c\density_function\overworld\base_3d_noise.lua", "Lua", 0, -8, 0, 0, -8
"c:\Users\haoti\Documents\GitHub\blockgamev2\src\ReplicatedStorage\BehaviorPacks\Cubic\WorldGeneration\c\density_function\overworld\continents.lua", "Lua", 0, -13, 0, 0, -13
"c:\Users\haoti\Documents\GitHub\blockgamev2\src\ReplicatedStorage\BehaviorPacks\Cubic\WorldGeneration\c\density_function\overworld\depth.lua", "Lua", 0, -18, 0, 0, -18
"c:\Users\haoti\Documents\GitHub\blockgamev2\src\ReplicatedStorage\BehaviorPacks\Cubic\WorldGeneration\c\density_function\overworld\erosion.lua", "Lua", 0, -13, 0, 0, -13
"c:\Users\haoti\Documents\GitHub\blockgamev2\src\ReplicatedStorage\BehaviorPacks\Cubic\WorldGeneration\c\density_function\overworld\factor.lua", "Lua", 0, -709, 0, 0, -709
"c:\Users\haoti\Documents\GitHub\blockgamev2\src\ReplicatedStorage\BehaviorPacks\Cubic\WorldGeneration\c\density_function\overworld\jaggedness.lua", "Lua", 0, -246, 0, 0, -246
"c:\Users\haoti\Documents\GitHub\blockgamev2\src\ReplicatedStorage\BehaviorPacks\Cubic\WorldGeneration\c\density_function\overworld\offset.lua", "Lua", 0, -1200, 0, -1, -1201
"c:\Users\haoti\Documents\GitHub\blockgamev2\src\ReplicatedStorage\BehaviorPacks\Cubic\WorldGeneration\c\density_function\overworld\ridges.lua", "Lua", 0, -13, 0, 0, -13
"c:\Users\haoti\Documents\GitHub\blockgamev2\src\ReplicatedStorage\BehaviorPacks\Cubic\WorldGeneration\c\density_function\overworld\ridges_folded.lua", "Lua", 0, -19, 0, 0, -19
"c:\Users\haoti\Documents\GitHub\blockgamev2\src\ReplicatedStorage\BehaviorPacks\Cubic\WorldGeneration\c\density_function\overworld\sloped_cheese.lua", "Lua", 0, -32, 0, 0, -32
"c:\Users\haoti\Documents\GitHub\blockgamev2\src\ReplicatedStorage\BehaviorPacks\Cubic\WorldGeneration\c\density_function\shift_x.lua", "Lua", 0, -10, 0, 0, -10
"c:\Users\haoti\Documents\GitHub\blockgamev2\src\ReplicatedStorage\BehaviorPacks\Cubic\WorldGeneration\c\density_function\shift_z.lua", "Lua", 0, -10, 0, 0, -10
"c:\Users\haoti\Documents\GitHub\blockgamev2\src\ReplicatedStorage\BehaviorPacks\Cubic\WorldGeneration\c\density_function\y.lua", "Lua", 0, -7, 0, 0, -7
"c:\Users\haoti\Documents\GitHub\blockgamev2\src\ReplicatedStorage\BehaviorPacks\Cubic\WorldGeneration\c\density_function\zero.lua", "Lua", 0, -1, 0, 0, -1
"c:\Users\haoti\Documents\GitHub\blockgamev2\src\ReplicatedStorage\BehaviorPacks\Cubic\WorldGeneration\c\noise.lua", "Lua", 0, -41, 0, -1, -42
"c:\Users\haoti\Documents\GitHub\blockgamev2\src\ReplicatedStorage\BehaviorPacks\Cubic\WorldGeneration\c\noise_settings\overworld.lua", "Lua", 0, -273, 0, -4, -277
"c:\Users\haoti\Documents\GitHub\blockgamev2\src\ReplicatedStorage\BlockPool.lua", "Lua", 0, 55, 0, 13, 68
"c:\Users\haoti\Documents\GitHub\blockgamev2\src\ReplicatedStorage\ChunkV2\init.lua", "Lua", 0, 46, 1, 5, 52
"c:\Users\haoti\Documents\GitHub\blockgamev2\src\ReplicatedStorage\CollisonHandler.lua", "Lua", 0, -59, -2, 2, -59
"c:\Users\haoti\Documents\GitHub\blockgamev2\src\ReplicatedStorage\DataHandler\DoFunc.model.json", "JSON", -3, 0, 0, -1, -4
"c:\Users\haoti\Documents\GitHub\blockgamev2\src\ReplicatedStorage\DataHandler\LoadedEntities.lua", "Lua", 0, -52, 0, -1, -53
"c:\Users\haoti\Documents\GitHub\blockgamev2\src\ReplicatedStorage\DataHandler\init.lua", "Lua", 0, -161, -5, -3, -169
"c:\Users\haoti\Documents\GitHub\blockgamev2\src\ReplicatedStorage\Data\init.lua", "Lua", 0, 29, 0, 0, 29
"c:\Users\haoti\Documents\GitHub\blockgamev2\src\ReplicatedStorage\EntityHandlerV2\EntityCollisionHandler.lua", "Lua", 0, 2, 0, 0, 2
"c:\Users\haoti\Documents\GitHub\blockgamev2\src\ReplicatedStorage\EntityHandlerV2\EntityReplicator\Client.lua", "Lua", 0, -3, 0, 0, -3
"c:\Users\haoti\Documents\GitHub\blockgamev2\src\ReplicatedStorage\EntityHandlerV2\EntityReplicator\ReplicatorUtils.lua", "Lua", 0, -2, 0, 0, -2
"c:\Users\haoti\Documents\GitHub\blockgamev2\src\ReplicatedStorage\EntityHandlerV2\Render.lua", "Lua", 0, -2, 1, 0, -1
"c:\Users\haoti\Documents\GitHub\blockgamev2\src\ReplicatedStorage\EntityHandlerV2\Utils.lua", "Lua", 0, -1, 0, 0, -1
"c:\Users\haoti\Documents\GitHub\blockgamev2\src\ReplicatedStorage\Events\ChunkV2.model.json", "JSON", 3, 0, 0, 1, 4
"c:\Users\haoti\Documents\GitHub\blockgamev2\src\ReplicatedStorage\GameSettings.lua", "Lua", 0, 0, 1, 0, 1
"c:\Users\haoti\Documents\GitHub\blockgamev2\src\ReplicatedStorage\Libarys\MathFunctions.lua", "Lua", 0, 1, 0, 0, 1
"c:\Users\haoti\Documents\GitHub\blockgamev2\src\ReplicatedStorage\QuickFunctions\init.lua", "Lua", 0, -498, -15, -4, -517
"c:\Users\haoti\Documents\GitHub\blockgamev2\src\ReplicatedStorage\ResourceHandler.lua", "Lua", 0, -20, -6, 1, -25
"c:\Users\haoti\Documents\GitHub\blockgamev2\src\ReplicatedStorage\Runner.lua", "Lua", 0, 38, 0, 3, 41
"c:\Users\haoti\Documents\GitHub\blockgamev2\src\ReplicatedStorage\Utils\BlockUtils.lua", "Lua", 0, 38, 0, 16, 54
"c:\Users\haoti\Documents\GitHub\blockgamev2\src\ReplicatedStorage\Utils\ConversionUtils.lua", "Lua", 0, 6, 3, 7, 16
"c:\Users\haoti\Documents\GitHub\blockgamev2\src\ReplicatedStorage\Utils\IndexUtils.lua", "Lua", 0, 32, 0, 6, 38
"c:\Users\haoti\Documents\GitHub\blockgamev2\src\ReplicatedStorage\core\BlockPool.lua", "Lua", 0, -119, -1, -21, -141
"c:\Users\haoti\Documents\GitHub\blockgamev2\src\ReplicatedStorage\core\init.lua", "Lua", 0, -38, 0, -3, -41
"c:\Users\haoti\Documents\GitHub\blockgamev2\src\ServerScriptService\__Init__.server.lua", "Lua", 0, -166, -24, -13, -203
"c:\Users\haoti\Documents\GitHub\blockgamev2\src\ServerScriptService\__init2__.server.lua", "Lua", 0, 3, 0, 1, 4
"c:\Users\haoti\Documents\GitHub\blockgamev2\src\ServerStorage\DataStores\BlockSaver.lua", "Lua", 0, -90, -6, 0, -96
"c:\Users\haoti\Documents\GitHub\blockgamev2\src\ServerStorage\DataStores\init.lua", "Lua", 0, -2, 0, -1, -3
"c:\Users\haoti\Documents\GitHub\blockgamev2\src\ServerStorage\Deepslate\core\Holder.lua", "Lua", 0, -32, 0, -4, -36
"c:\Users\haoti\Documents\GitHub\blockgamev2\src\ServerStorage\Deepslate\core\Identifier.lua", "Lua", 0, -35, -6, -7, -48
"c:\Users\haoti\Documents\GitHub\blockgamev2\src\ServerStorage\Deepslate\core\Registry.lua", "Lua", 0, -72, 0, 0, -72
"c:\Users\haoti\Documents\GitHub\blockgamev2\src\ServerStorage\Deepslate\core\Storage.lua", "Lua", 0, -22, 0, -2, -24
"c:\Users\haoti\Documents\GitHub\blockgamev2\src\ServerStorage\Deepslate\core\init.lua", "Lua", 0, -1, 0, 0, -1
"c:\Users\haoti\Documents\GitHub\blockgamev2\src\ServerStorage\Deepslate\init.lua", "Lua", 0, -10, 0, 0, -10
"c:\Users\haoti\Documents\GitHub\blockgamev2\src\ServerStorage\Deepslate\math\CubicSpline.lua", "Lua", 0, -176, -5, -7, -188
"c:\Users\haoti\Documents\GitHub\blockgamev2\src\ServerStorage\Deepslate\math\Hash.lua", "Lua", 0, -17, -1, -3, -21
"c:\Users\haoti\Documents\GitHub\blockgamev2\src\ServerStorage\Deepslate\math\RandomObject.lua", "Lua", 0, -33, 0, -4, -37
"c:\Users\haoti\Documents\GitHub\blockgamev2\src\ServerStorage\Deepslate\math\Utils.lua", "Lua", 0, -82, -2, -9, -93
"c:\Users\haoti\Documents\GitHub\blockgamev2\src\ServerStorage\Deepslate\math\init.lua", "Lua", 0, -7, 0, 0, -7
"c:\Users\haoti\Documents\GitHub\blockgamev2\src\ServerStorage\Deepslate\math\noise\BlendedNoise.lua", "Lua", 0, -68, 0, -3, -71
"c:\Users\haoti\Documents\GitHub\blockgamev2\src\ServerStorage\Deepslate\math\noise\ImprovedNoise.lua", "Lua", 0, -73, -2, -10, -85
"c:\Users\haoti\Documents\GitHub\blockgamev2\src\ServerStorage\Deepslate\math\noise\NormalNoise.lua", "Lua", 0, -30, 0, -6, -36
"c:\Users\haoti\Documents\GitHub\blockgamev2\src\ServerStorage\Deepslate\math\noise\PerlineNoise.lua", "Lua", 0, -65, -1, -7, -73
"c:\Users\haoti\Documents\GitHub\blockgamev2\src\ServerStorage\Deepslate\math\noise\SimplexNoise.lua", "Lua", 0, -124, 0, -9, -133
"c:\Users\haoti\Documents\GitHub\blockgamev2\src\ServerStorage\Deepslate\math\noise\init.lua", "Lua", 0, -7, 0, 0, -7
"c:\Users\haoti\Documents\GitHub\blockgamev2\src\ServerStorage\Deepslate\worldgen\DensityFunction.lua", "Lua", 0, -744, -3, -61, -808
"c:\Users\haoti\Documents\GitHub\blockgamev2\src\ServerStorage\Deepslate\worldgen\NoiseGeneratorSettings.lua", "Lua", 0, -36, -8, -5, -49
"c:\Users\haoti\Documents\GitHub\blockgamev2\src\ServerStorage\Deepslate\worldgen\NoiseParameters.lua", "Lua", 0, -8, 0, 0, -8
"c:\Users\haoti\Documents\GitHub\blockgamev2\src\ServerStorage\Deepslate\worldgen\NoiseRouter.lua", "Lua", 0, -120, 0, -17, -137
"c:\Users\haoti\Documents\GitHub\blockgamev2\src\ServerStorage\Deepslate\worldgen\NoiseSettings.lua", "Lua", 0, -49, 0, -8, -57
"c:\Users\haoti\Documents\GitHub\blockgamev2\src\ServerStorage\Deepslate\worldgen\RandomState.lua", "Lua", 0, -114, -1, -4, -119
"c:\Users\haoti\Documents\GitHub\blockgamev2\src\ServerStorage\Deepslate\worldgen\WorldgenRegistries.lua", "Lua", 0, -30, 0, 0, -30
"c:\Users\haoti\Documents\GitHub\blockgamev2\src\ServerStorage\Deepslate\worldgen\biome\BiomeParser.lua", "Lua", 0, -25, 0, 0, -25
"c:\Users\haoti\Documents\GitHub\blockgamev2\src\ServerStorage\Deepslate\worldgen\biome\Climate.lua", "Lua", 0, -329, -1, -31, -361
"c:\Users\haoti\Documents\GitHub\blockgamev2\src\ServerStorage\Deepslate\worldgen\biome\FeatureParser.lua", "Lua", 0, -78, -18, -2, -98
"c:\Users\haoti\Documents\GitHub\blockgamev2\src\ServerStorage\Deepslate\worldgen\biome\MultiNoiseBiomeSource.lua", "Lua", 0, -29, 0, -2, -31
"c:\Users\haoti\Documents\GitHub\blockgamev2\src\ServerStorage\GenerationHandler\BiomeHandler.lua", "Lua", 0, -186, -1, -3, -190
"c:\Users\haoti\Documents\GitHub\blockgamev2\src\ServerStorage\GenerationHandler\MultiHandler.lua", "Lua", 0, -29, 0, 0, -29
"c:\Users\haoti\Documents\GitHub\blockgamev2\src\ServerStorage\GenerationHandler\TerrianHandler.lua", "Lua", 0, -631, -25, -23, -679
"c:\Users\haoti\Documents\GitHub\blockgamev2\src\ServerStorage\GenerationHandler\init.lua", "Lua", 0, -262, -5, -12, -279
"c:\Users\haoti\Documents\GitHub\blockgamev2\src\ServerStorage\GenerationMultiHandler.lua", "Lua", 0, -513, -9, -16, -538
"c:\Users\haoti\Documents\GitHub\blockgamev2\src\ServerStorage\PathFinding.lua", "Lua", 0, -253, -26, -13, -292
"c:\Users\haoti\Documents\GitHub\blockgamev2\src\ServerStorage\PlayerControlsHandler.lua", "Lua", 0, -35, 0, -2, -37
"c:\Users\haoti\Documents\GitHub\blockgamev2\src\ServerStorage\ServerEntity\EntityBehaviorHandler.lua", "Lua", 0, -106, 0, -2, -108
"c:\Users\haoti\Documents\GitHub\blockgamev2\src\ServerStorage\ServerEntity\EntityReplicatorServer.lua", "Lua", 0, -238, -6, -4, -248
"c:\Users\haoti\Documents\GitHub\blockgamev2\src\ServerStorage\ServerStuff\DataHandler.lua", "Lua", 0, -221, -14, -16, -251
"c:\Users\haoti\Documents\GitHub\blockgamev2\src\ServerStorage\ServerStuff\ServerChunk.lua", "Lua", 0, -261, -16, -4, -281
"c:\Users\haoti\Documents\GitHub\blockgamev2\src\ServerStorage\ServerStuff\SharedService.lua", "Lua", 0, -54, -3, -3, -60
"c:\Users\haoti\Documents\GitHub\blockgamev2\src\ServerStorage\core\Chunk\Generator\init.lua", "Lua", 0, 16, 0, 0, 16
"c:\Users\haoti\Documents\GitHub\blockgamev2\src\ServerStorage\core\Chunk\manager.lua", "Lua", 0, 10, 0, 2, 12
"c:\Users\haoti\Documents\GitHub\blockgamev2\src\ServerStorage\core\Entity\EntityBehaviorHandler.lua", "Lua", 0, 106, 0, 2, 108
"c:\Users\haoti\Documents\GitHub\blockgamev2\src\ServerStorage\core\Entity\EntityReplicatorServer.lua", "Lua", 0, 236, 6, 4, 246
"c:\Users\haoti\Documents\GitHub\blockgamev2\src\StarterPlayer\StarterPlayerScripts\ClientStuff\ClientChunk.lua", "Lua", 0, -20, 0, -1, -21
"c:\Users\haoti\Documents\GitHub\blockgamev2\src\StarterPlayer\StarterPlayerScripts\RenderV2\init.lua", "Lua", 0, 28, 0, 2, 30
"c:\Users\haoti\Documents\GitHub\blockgamev2\src\StarterPlayer\StarterPlayerScripts\Render\BlockHandler.lua", "Lua", 0, -185, -4, -1, -190
"c:\Users\haoti\Documents\GitHub\blockgamev2\src\StarterPlayer\StarterPlayerScripts\Render\ChunkShared.lua", "Lua", 0, -59, -1, -4, -64
"c:\Users\haoti\Documents\GitHub\blockgamev2\src\StarterPlayer\StarterPlayerScripts\Render\GreedyMesh.lua", "Lua", 0, -203, -3, 0, -206
"c:\Users\haoti\Documents\GitHub\blockgamev2\src\StarterPlayer\StarterPlayerScripts\Render\MultiHandler.lua", "Lua", 0, -117, -12, -9, -138
"c:\Users\haoti\Documents\GitHub\blockgamev2\src\StarterPlayer\StarterPlayerScripts\Render\RenderMultiFunctions.lua", "Lua", 0, -106, 0, -2, -108
"c:\Users\haoti\Documents\GitHub\blockgamev2\src\StarterPlayer\StarterPlayerScripts\Render\init.lua", "Lua", 0, -220, -9, -3, -232
"c:\Users\haoti\Documents\GitHub\blockgamev2\src\StarterPlayer\StarterPlayerScripts\ServerFpsHandler.lua", "Lua", 0, -12, -1, 0, -13
"c:\Users\haoti\Documents\GitHub\blockgamev2\src\StarterPlayer\StarterPlayerScripts\Test\EntityHandlerV2.lua", "Lua", 0, -66, -6, -1, -73
"c:\Users\haoti\Documents\GitHub\blockgamev2\src\StarterPlayer\StarterPlayerScripts\__init__.client.lua", "Lua", 0, -87, -5, -8, -100
"c:\Users\haoti\Documents\GitHub\blockgamev2\src\StarterPlayer\StarterPlayerScripts\__init__v2.client.lua", "Lua", 0, 5, 0, 1, 6
"c:\Users\haoti\Documents\GitHub\blockgamev2\src\Workspace\SimplexModule.lua", "Lua", 0, -253, -3, -58, -314
"Total", "-", 1, -10876, -262, -434, -11571