"filename", "language", "Lua", "JSON", "Markdown", "Log", "comment", "blank", "total"
"c:\Users\haoti\Documents\GitHub\blockgamev2\README.md", "Markdown", 0, 0, 12, 0, 0, 5, 17
"c:\Users\haoti\Documents\GitHub\blockgamev2\default.project.json", "JSON", 0, 48, 0, 0, 0, 0, 48
"c:\Users\haoti\Documents\GitHub\blockgamev2\rbxlx-to-rojo.log", "Log", 0, 0, 0, 2, 0, 1, 3
"c:\Users\haoti\Documents\GitHub\blockgamev2\src\ReplicatedStorage\AnimationController.lua", "Lua", 72, 0, 0, 0, 0, 0, 72
"c:\Users\haoti\Documents\GitHub\blockgamev2\src\ReplicatedStorage\BehaviorHandler.lua", "Lua", 185, 0, 0, 0, 2, 0, 187
"c:\Users\haoti\Documents\GitHub\blockgamev2\src\ReplicatedStorage\BehaviorPacks\Cubic\Behaviors.lua", "Lua", 84, 0, 0, 0, 1, 0, 85
"c:\Users\haoti\Documents\GitHub\blockgamev2\src\ReplicatedStorage\BehaviorPacks\Cubic\Biomes\init.lua", "Lua", 15, 0, 0, 0, 0, 1, 16
"c:\Users\haoti\Documents\GitHub\blockgamev2\src\ReplicatedStorage\BehaviorPacks\Cubic\BlockHitboxes\init.lua", "Lua", 21, 0, 0, 0, 0, 0, 21
"c:\Users\haoti\Documents\GitHub\blockgamev2\src\ReplicatedStorage\BehaviorPacks\Cubic\Blocks\init.lua", "Lua", 123, 0, 0, 0, 1, 19, 143
"c:\Users\haoti\Documents\GitHub\blockgamev2\src\ReplicatedStorage\BehaviorPacks\Cubic\Components.lua", "Lua", 23, 0, 0, 0, 0, 2, 25
"c:\Users\haoti\Documents\GitHub\blockgamev2\src\ReplicatedStorage\BehaviorPacks\Cubic\Crafting\init.lua", "Lua", 50, 0, 0, 0, 0, 6, 56
"c:\Users\haoti\Documents\GitHub\blockgamev2\src\ReplicatedStorage\BehaviorPacks\Cubic\Entities\Npc.lua", "Lua", 54, 0, 0, 0, 0, 2, 56
"c:\Users\haoti\Documents\GitHub\blockgamev2\src\ReplicatedStorage\BehaviorPacks\Cubic\Entities\Player.lua", "Lua", 35, 0, 0, 0, 0, 4, 39
"c:\Users\haoti\Documents\GitHub\blockgamev2\src\ReplicatedStorage\BehaviorPacks\Cubic\Entities\init.lua", "Lua", 28, 0, 0, 0, 0, 5, 33
"c:\Users\haoti\Documents\GitHub\blockgamev2\src\ReplicatedStorage\BehaviorPacks\Cubic\Features\init.lua", "Lua", 52, 0, 0, 0, 1, 1, 54
"c:\Users\haoti\Documents\GitHub\blockgamev2\src\ReplicatedStorage\BehaviorPacks\Cubic\Functions.lua", "Lua", 198, 0, 0, 0, 9, 3, 210
"c:\Users\haoti\Documents\GitHub\blockgamev2\src\ReplicatedStorage\BehaviorPacks\Cubic\Info.lua", "Lua", 2, 0, 0, 0, 0, 0, 2
"c:\Users\haoti\Documents\GitHub\blockgamev2\src\ReplicatedStorage\BehaviorPacks\Cubic\ItemTypes.lua", "Lua", 52, 0, 0, 0, 2, 3, 57
"c:\Users\haoti\Documents\GitHub\blockgamev2\src\ReplicatedStorage\BehaviorPacks\Cubic\Items\init.lua", "Lua", 80, 0, 0, 0, 1, 6, 87
"c:\Users\haoti\Documents\GitHub\blockgamev2\src\ReplicatedStorage\BehaviorPacks\Cubic\Server.lua", "Lua", 37, 0, 0, 0, 1, 2, 40
"c:\Users\haoti\Documents\GitHub\blockgamev2\src\ReplicatedStorage\BehaviorPacks\Cubic\WorldGeneration\c\density_function\overworld\CubicalSurface.lua", "Lua", 17, 0, 0, 0, 0, 0, 17
"c:\Users\haoti\Documents\GitHub\blockgamev2\src\ReplicatedStorage\BehaviorPacks\Cubic\WorldGeneration\c\density_function\overworld\base_3d_noise.lua", "Lua", 8, 0, 0, 0, 0, 0, 8
"c:\Users\haoti\Documents\GitHub\blockgamev2\src\ReplicatedStorage\BehaviorPacks\Cubic\WorldGeneration\c\density_function\overworld\continents.lua", "Lua", 13, 0, 0, 0, 0, 0, 13
"c:\Users\haoti\Documents\GitHub\blockgamev2\src\ReplicatedStorage\BehaviorPacks\Cubic\WorldGeneration\c\density_function\overworld\depth.lua", "Lua", 18, 0, 0, 0, 0, 0, 18
"c:\Users\haoti\Documents\GitHub\blockgamev2\src\ReplicatedStorage\BehaviorPacks\Cubic\WorldGeneration\c\density_function\overworld\erosion.lua", "Lua", 13, 0, 0, 0, 0, 0, 13
"c:\Users\haoti\Documents\GitHub\blockgamev2\src\ReplicatedStorage\BehaviorPacks\Cubic\WorldGeneration\c\density_function\overworld\factor.lua", "Lua", 709, 0, 0, 0, 0, 0, 709
"c:\Users\haoti\Documents\GitHub\blockgamev2\src\ReplicatedStorage\BehaviorPacks\Cubic\WorldGeneration\c\density_function\overworld\jaggedness.lua", "Lua", 246, 0, 0, 0, 0, 0, 246
"c:\Users\haoti\Documents\GitHub\blockgamev2\src\ReplicatedStorage\BehaviorPacks\Cubic\WorldGeneration\c\density_function\overworld\offset.lua", "Lua", 1200, 0, 0, 0, 0, 1, 1201
"c:\Users\haoti\Documents\GitHub\blockgamev2\src\ReplicatedStorage\BehaviorPacks\Cubic\WorldGeneration\c\density_function\overworld\ridges.lua", "Lua", 13, 0, 0, 0, 0, 0, 13
"c:\Users\haoti\Documents\GitHub\blockgamev2\src\ReplicatedStorage\BehaviorPacks\Cubic\WorldGeneration\c\density_function\overworld\ridges_folded.lua", "Lua", 19, 0, 0, 0, 0, 0, 19
"c:\Users\haoti\Documents\GitHub\blockgamev2\src\ReplicatedStorage\BehaviorPacks\Cubic\WorldGeneration\c\density_function\overworld\sloped_cheese.lua", "Lua", 32, 0, 0, 0, 0, 0, 32
"c:\Users\haoti\Documents\GitHub\blockgamev2\src\ReplicatedStorage\BehaviorPacks\Cubic\WorldGeneration\c\density_function\shift_x.lua", "Lua", 10, 0, 0, 0, 0, 0, 10
"c:\Users\haoti\Documents\GitHub\blockgamev2\src\ReplicatedStorage\BehaviorPacks\Cubic\WorldGeneration\c\density_function\shift_z.lua", "Lua", 10, 0, 0, 0, 0, 0, 10
"c:\Users\haoti\Documents\GitHub\blockgamev2\src\ReplicatedStorage\BehaviorPacks\Cubic\WorldGeneration\c\density_function\y.lua", "Lua", 7, 0, 0, 0, 0, 0, 7
"c:\Users\haoti\Documents\GitHub\blockgamev2\src\ReplicatedStorage\BehaviorPacks\Cubic\WorldGeneration\c\density_function\zero.lua", "Lua", 1, 0, 0, 0, 0, 0, 1
"c:\Users\haoti\Documents\GitHub\blockgamev2\src\ReplicatedStorage\BehaviorPacks\Cubic\WorldGeneration\c\noise.lua", "Lua", 41, 0, 0, 0, 0, 1, 42
"c:\Users\haoti\Documents\GitHub\blockgamev2\src\ReplicatedStorage\BehaviorPacks\Cubic\WorldGeneration\c\noise_settings\overworld.lua", "Lua", 273, 0, 0, 0, 0, 4, 277
"c:\Users\haoti\Documents\GitHub\blockgamev2\src\ReplicatedStorage\BridgeNet\Bridge.lua", "Lua", 19, 0, 0, 0, 0, 2, 21
"c:\Users\haoti\Documents\GitHub\blockgamev2\src\ReplicatedStorage\BridgeNet\ClientBridge.lua", "Lua", 351, 0, 0, 0, 12, 88, 451
"c:\Users\haoti\Documents\GitHub\blockgamev2\src\ReplicatedStorage\BridgeNet\CreateBridgeTree.lua", "Lua", 45, 0, 0, 0, 0, 13, 58
"c:\Users\haoti\Documents\GitHub\blockgamev2\src\ReplicatedStorage\BridgeNet\SerdesLayer.lua", "Lua", 173, 0, 0, 0, 9, 51, 233
"c:\Users\haoti\Documents\GitHub\blockgamev2\src\ReplicatedStorage\BridgeNet\ServerBridge.lua", "Lua", 636, 0, 0, 0, 24, 126, 786
"c:\Users\haoti\Documents\GitHub\blockgamev2\src\ReplicatedStorage\BridgeNet\init.lua", "Lua", 148, 0, 0, 0, 9, 37, 194
"c:\Users\haoti\Documents\GitHub\blockgamev2\src\ReplicatedStorage\Chunk.lua", "Lua", 278, 0, 0, 0, 0, 5, 283
"c:\Users\haoti\Documents\GitHub\blockgamev2\src\ReplicatedStorage\CollisonHandler.lua", "Lua", 638, 0, 0, 0, 36, 19, 693
"c:\Users\haoti\Documents\GitHub\blockgamev2\src\ReplicatedStorage\DataHandler\DoFunc.model.json", "JSON", 0, 3, 0, 0, 0, 1, 4
"c:\Users\haoti\Documents\GitHub\blockgamev2\src\ReplicatedStorage\DataHandler\LoadedEntities.lua", "Lua", 52, 0, 0, 0, 0, 1, 53
"c:\Users\haoti\Documents\GitHub\blockgamev2\src\ReplicatedStorage\DataHandler\init.lua", "Lua", 162, 0, 0, 0, 5, 3, 170
"c:\Users\haoti\Documents\GitHub\blockgamev2\src\ReplicatedStorage\EntityHandler.lua", "Lua", 1242, 0, 0, 0, 44, 16, 1302
"c:\Users\haoti\Documents\GitHub\blockgamev2\src\ReplicatedStorage\EntityMovers\Curve.lua", "Lua", 80, 0, 0, 0, 7, 1, 88
"c:\Users\haoti\Documents\GitHub\blockgamev2\src\ReplicatedStorage\EntityMovers\MoveTo.lua", "Lua", 58, 0, 0, 0, 2, 0, 60
"c:\Users\haoti\Documents\GitHub\blockgamev2\src\ReplicatedStorage\EntityMovers\init.lua", "Lua", 5, 0, 0, 0, 0, 0, 5
"c:\Users\haoti\Documents\GitHub\blockgamev2\src\ReplicatedStorage\Events\DoSmt.model.json", "JSON", 0, 3, 0, 0, 0, 1, 4
"c:\Users\haoti\Documents\GitHub\blockgamev2\src\ReplicatedStorage\Events\EntityUpdater.model.json", "JSON", 0, 3, 0, 0, 0, 1, 4
"c:\Users\haoti\Documents\GitHub\blockgamev2\src\ReplicatedStorage\Events\GetChunk.model.json", "JSON", 0, 3, 0, 0, 0, 1, 4
"c:\Users\haoti\Documents\GitHub\blockgamev2\src\ReplicatedStorage\Events\KB.model.json", "JSON", 0, 3, 0, 0, 0, 1, 4
"c:\Users\haoti\Documents\GitHub\blockgamev2\src\ReplicatedStorage\Events\LOAD.model.json", "JSON", 0, 3, 0, 0, 0, 1, 4
"c:\Users\haoti\Documents\GitHub\blockgamev2\src\ReplicatedStorage\Events\OnDeath.model.json", "JSON", 0, 3, 0, 0, 0, 1, 4
"c:\Users\haoti\Documents\GitHub\blockgamev2\src\ReplicatedStorage\Events\Respawn.model.json", "JSON", 0, 3, 0, 0, 0, 1, 4
"c:\Users\haoti\Documents\GitHub\blockgamev2\src\ReplicatedStorage\Events\SendEntities.model.json", "JSON", 0, 3, 0, 0, 0, 1, 4
"c:\Users\haoti\Documents\GitHub\blockgamev2\src\ReplicatedStorage\Events\ServerFPS.model.json", "JSON", 0, 3, 0, 0, 0, 1, 4
"c:\Users\haoti\Documents\GitHub\blockgamev2\src\ReplicatedStorage\GameSettings.lua", "Lua", 68, 0, 0, 0, 8, 0, 76
"c:\Users\haoti\Documents\GitHub\blockgamev2\src\ReplicatedStorage\ItemHandler.lua", "Lua", 94, 0, 0, 0, 0, 1, 95
"c:\Users\haoti\Documents\GitHub\blockgamev2\src\ReplicatedStorage\Libarys\Bezier.lua", "Lua", 168, 0, 0, 0, 49, 87, 304
"c:\Users\haoti\Documents\GitHub\blockgamev2\src\ReplicatedStorage\Libarys\BlockPool.lua", "Lua", 120, 0, 0, 0, 3, 5, 128
"c:\Users\haoti\Documents\GitHub\blockgamev2\src\ReplicatedStorage\Libarys\Debris.lua", "Lua", 53, 0, 0, 0, 0, 0, 53
"c:\Users\haoti\Documents\GitHub\blockgamev2\src\ReplicatedStorage\Libarys\Debugger.lua", "Lua", 25, 0, 0, 0, 9, 0, 34
"c:\Users\haoti\Documents\GitHub\blockgamev2\src\ReplicatedStorage\Libarys\DelayHandler.lua", "Lua", 47, 0, 0, 0, 0, 1, 48
"c:\Users\haoti\Documents\GitHub\blockgamev2\src\ReplicatedStorage\Libarys\EntityAttribute.lua", "Lua", 153, 0, 0, 0, 5, 0, 158
"c:\Users\haoti\Documents\GitHub\blockgamev2\src\ReplicatedStorage\Libarys\GlobalDebris.lua", "Lua", 61, 0, 0, 0, 0, 2, 63
"c:\Users\haoti\Documents\GitHub\blockgamev2\src\ReplicatedStorage\Libarys\Grid.lua", "Lua", 22, 0, 0, 0, 0, 1, 23
"c:\Users\haoti\Documents\GitHub\blockgamev2\src\ReplicatedStorage\Libarys\MathFunctions.lua", "Lua", 121, 0, 0, 0, 2, 2, 125
"c:\Users\haoti\Documents\GitHub\blockgamev2\src\ReplicatedStorage\Libarys\ModingRemote\init.lua", "Lua", 56, 0, 0, 0, 0, 1, 57
"c:\Users\haoti\Documents\GitHub\blockgamev2\src\ReplicatedStorage\Libarys\PlayerControls.lua", "Lua", 73, 0, 0, 0, 0, 5, 78
"c:\Users\haoti\Documents\GitHub\blockgamev2\src\ReplicatedStorage\Libarys\ProxyTable.lua", "Lua", 64, 0, 0, 0, 0, 0, 64
"c:\Users\haoti\Documents\GitHub\blockgamev2\src\ReplicatedStorage\Libarys\RotationData.lua", "Lua", 179, 0, 0, 0, 0, 0, 179
"c:\Users\haoti\Documents\GitHub\blockgamev2\src\ReplicatedStorage\Libarys\Signal.lua", "Lua", 58, 0, 0, 0, 1, 17, 76
"c:\Users\haoti\Documents\GitHub\blockgamev2\src\ReplicatedStorage\Libarys\Store.lua", "Lua", 60, 0, 0, 0, 0, 0, 60
"c:\Users\haoti\Documents\GitHub\blockgamev2\src\ReplicatedStorage\Libarys\Worker.lua", "Lua", 78, 0, 0, 0, 1, 1, 80
"c:\Users\haoti\Documents\GitHub\blockgamev2\src\ReplicatedStorage\Libarys\compressor.lua", "Lua", 169, 0, 0, 0, 2, 12, 183
"c:\Users\haoti\Documents\GitHub\blockgamev2\src\ReplicatedStorage\Libarys\lualzw.lua", "Lua", 146, 0, 0, 0, 1, 18, 165
"c:\Users\haoti\Documents\GitHub\blockgamev2\src\ReplicatedStorage\Libarys\simplexNoise.lua", "Lua", 395, 0, 0, 0, 54, 96, 545
"c:\Users\haoti\Documents\GitHub\blockgamev2\src\ReplicatedStorage\Managers\ArmsManager.lua", "Lua", 188, 0, 0, 0, 1, 3, 192
"c:\Users\haoti\Documents\GitHub\blockgamev2\src\ReplicatedStorage\Managers\CraftingManager.lua", "Lua", 144, 0, 0, 0, 3, 3, 150
"c:\Users\haoti\Documents\GitHub\blockgamev2\src\ReplicatedStorage\Managers\HotBarManager.lua", "Lua", 68, 0, 0, 0, 0, 0, 68
"c:\Users\haoti\Documents\GitHub\blockgamev2\src\ReplicatedStorage\Managers\InventoryManager.lua", "Lua", 129, 0, 0, 0, 18, 3, 150
"c:\Users\haoti\Documents\GitHub\blockgamev2\src\ReplicatedStorage\Managers\PlayerDollHandler.lua", "Lua", 38, 0, 0, 0, 0, 1, 39
"c:\Users\haoti\Documents\GitHub\blockgamev2\src\ReplicatedStorage\Managers\UIContainerManager.lua", "Lua", 311, 0, 0, 0, 2, 9, 322
"c:\Users\haoti\Documents\GitHub\blockgamev2\src\ReplicatedStorage\Managers\init.lua", "Lua", 11, 0, 0, 0, 0, 0, 11
"c:\Users\haoti\Documents\GitHub\blockgamev2\src\ReplicatedStorage\ModHandler\init.lua", "Lua", 223, 0, 0, 0, 9, 29, 261
"c:\Users\haoti\Documents\GitHub\blockgamev2\src\ReplicatedStorage\MultiHandler\FunctionsToMultiThread.lua", "Lua", 19, 0, 0, 0, 0, 2, 21
"c:\Users\haoti\Documents\GitHub\blockgamev2\src\ReplicatedStorage\MultiHandler\init.lua", "Lua", 56, 0, 0, 0, 0, 1, 57
"c:\Users\haoti\Documents\GitHub\blockgamev2\src\ReplicatedStorage\Oldstuff\BridgeNetO\Bridge.lua", "Lua", 16, 0, 0, 0, 0, 1, 17
"c:\Users\haoti\Documents\GitHub\blockgamev2\src\ReplicatedStorage\Oldstuff\BridgeNetO\ClientBridge.lua", "Lua", 351, 0, 0, 0, 12, 87, 450
"c:\Users\haoti\Documents\GitHub\blockgamev2\src\ReplicatedStorage\Oldstuff\BridgeNetO\CreateBridgeTree.lua", "Lua", 34, 0, 0, 0, 1, 8, 43
"c:\Users\haoti\Documents\GitHub\blockgamev2\src\ReplicatedStorage\Oldstuff\BridgeNetO\SerdesLayer.lua", "Lua", 165, 0, 0, 0, 8, 47, 220
"c:\Users\haoti\Documents\GitHub\blockgamev2\src\ReplicatedStorage\Oldstuff\BridgeNetO\ServerBridge.lua", "Lua", 636, 0, 0, 0, 24, 125, 785
"c:\Users\haoti\Documents\GitHub\blockgamev2\src\ReplicatedStorage\Oldstuff\BridgeNetO\init.lua", "Lua", 105, 0, 0, 0, 4, 27, 136
"c:\Users\haoti\Documents\GitHub\blockgamev2\src\ReplicatedStorage\Oldstuff\CHUNKOLD.lua", "Lua", 133, 0, 0, 0, 8, 1, 142
"c:\Users\haoti\Documents\GitHub\blockgamev2\src\ReplicatedStorage\Oldstuff\LargeChunk.lua", "Lua", 54, 0, 0, 0, 0, 1, 55
"c:\Users\haoti\Documents\GitHub\blockgamev2\src\ReplicatedStorage\Oldstuff\MultiHandler\FunctionsToMultiThread.lua", "Lua", 134, 0, 0, 0, 2, 2, 138
"c:\Users\haoti\Documents\GitHub\blockgamev2\src\ReplicatedStorage\Oldstuff\MultiHandler\GlobalMemory.lua", "Lua", 35, 0, 0, 0, 0, 1, 36
"c:\Users\haoti\Documents\GitHub\blockgamev2\src\ReplicatedStorage\Oldstuff\MultiHandler\init.lua", "Lua", 222, 0, 0, 0, 17, 4, 243
"c:\Users\haoti\Documents\GitHub\blockgamev2\src\ReplicatedStorage\Oldstuff\OLD Culling copy.lua", "Lua", 137, 0, 0, 0, 5, 2, 144
"c:\Users\haoti\Documents\GitHub\blockgamev2\src\ReplicatedStorage\Oldstuff\Old Chunk copy.lua", "Lua", 154, 0, 0, 0, 32, 7, 193
"c:\Users\haoti\Documents\GitHub\blockgamev2\src\ReplicatedStorage\Oldstuff\OldGenerationManager.lua", "Lua", 356, 0, 0, 0, 18, 18, 392
"c:\Users\haoti\Documents\GitHub\blockgamev2\src\ReplicatedStorage\Oldstuff\OldRender.lua", "Lua", 408, 0, 0, 0, 34, 6, 448
"c:\Users\haoti\Documents\GitHub\blockgamev2\src\ReplicatedStorage\Oldstuff\cullingv2.lua", "Lua", 92, 0, 0, 0, 2, 2, 96
"c:\Users\haoti\Documents\GitHub\blockgamev2\src\ReplicatedStorage\QuickFunctions\init.lua", "Lua", 498, 0, 0, 0, 15, 4, 517
"c:\Users\haoti\Documents\GitHub\blockgamev2\src\ReplicatedStorage\Ray.lua", "Lua", 98, 0, 0, 0, 1, 0, 99
"c:\Users\haoti\Documents\GitHub\blockgamev2\src\ReplicatedStorage\RenderStuff\Culling.lua", "Lua", 128, 0, 0, 0, 2, 2, 132
"c:\Users\haoti\Documents\GitHub\blockgamev2\src\ReplicatedStorage\RenderStuff\GreedyMesh.lua", "Lua", 208, 0, 0, 0, 7, 0, 215
"c:\Users\haoti\Documents\GitHub\blockgamev2\src\ReplicatedStorage\RenderStuff\GreedyMeshingHandler.lua", "Lua", 13, 0, 0, 0, 1, 12, 26
"c:\Users\haoti\Documents\GitHub\blockgamev2\src\ReplicatedStorage\RenderStuff\Render.lua", "Lua", 325, 0, 0, 0, 7, 6, 338
"c:\Users\haoti\Documents\GitHub\blockgamev2\src\ReplicatedStorage\ResourceHandler.lua", "Lua", 90, 0, 0, 0, 6, 3, 99
"c:\Users\haoti\Documents\GitHub\blockgamev2\src\ServerScriptService\__Init__.server.lua", "Lua", 250, 0, 0, 0, 18, 8, 276
"c:\Users\haoti\Documents\GitHub\blockgamev2\src\ServerStorage\DataStores\BlockSaver.lua", "Lua", 90, 0, 0, 0, 6, 0, 96
"c:\Users\haoti\Documents\GitHub\blockgamev2\src\ServerStorage\DataStores\init.lua", "Lua", 2, 0, 0, 0, 0, 1, 3
"c:\Users\haoti\Documents\GitHub\blockgamev2\src\ServerStorage\Deepslate\core\Holder.lua", "Lua", 32, 0, 0, 0, 0, 4, 36
"c:\Users\haoti\Documents\GitHub\blockgamev2\src\ServerStorage\Deepslate\core\Identifier.lua", "Lua", 35, 0, 0, 0, 6, 7, 48
"c:\Users\haoti\Documents\GitHub\blockgamev2\src\ServerStorage\Deepslate\core\Registry.lua", "Lua", 72, 0, 0, 0, 0, 0, 72
"c:\Users\haoti\Documents\GitHub\blockgamev2\src\ServerStorage\Deepslate\core\Storage.lua", "Lua", 22, 0, 0, 0, 0, 2, 24
"c:\Users\haoti\Documents\GitHub\blockgamev2\src\ServerStorage\Deepslate\core\init.lua", "Lua", 1, 0, 0, 0, 0, 0, 1
"c:\Users\haoti\Documents\GitHub\blockgamev2\src\ServerStorage\Deepslate\init.lua", "Lua", 10, 0, 0, 0, 0, 0, 10
"c:\Users\haoti\Documents\GitHub\blockgamev2\src\ServerStorage\Deepslate\math\CubicSpline.lua", "Lua", 176, 0, 0, 0, 5, 7, 188
"c:\Users\haoti\Documents\GitHub\blockgamev2\src\ServerStorage\Deepslate\math\Hash.lua", "Lua", 17, 0, 0, 0, 1, 3, 21
"c:\Users\haoti\Documents\GitHub\blockgamev2\src\ServerStorage\Deepslate\math\RandomObject.lua", "Lua", 33, 0, 0, 0, 0, 4, 37
"c:\Users\haoti\Documents\GitHub\blockgamev2\src\ServerStorage\Deepslate\math\Utils.lua", "Lua", 82, 0, 0, 0, 2, 8, 92
"c:\Users\haoti\Documents\GitHub\blockgamev2\src\ServerStorage\Deepslate\math\init.lua", "Lua", 7, 0, 0, 0, 0, 0, 7
"c:\Users\haoti\Documents\GitHub\blockgamev2\src\ServerStorage\Deepslate\math\noise\BlendedNoise.lua", "Lua", 68, 0, 0, 0, 0, 3, 71
"c:\Users\haoti\Documents\GitHub\blockgamev2\src\ServerStorage\Deepslate\math\noise\ImprovedNoise.lua", "Lua", 73, 0, 0, 0, 2, 10, 85
"c:\Users\haoti\Documents\GitHub\blockgamev2\src\ServerStorage\Deepslate\math\noise\NormalNoise.lua", "Lua", 30, 0, 0, 0, 0, 6, 36
"c:\Users\haoti\Documents\GitHub\blockgamev2\src\ServerStorage\Deepslate\math\noise\PerlineNoise.lua", "Lua", 65, 0, 0, 0, 1, 7, 73
"c:\Users\haoti\Documents\GitHub\blockgamev2\src\ServerStorage\Deepslate\math\noise\SimplexNoise.lua", "Lua", 124, 0, 0, 0, 0, 9, 133
"c:\Users\haoti\Documents\GitHub\blockgamev2\src\ServerStorage\Deepslate\math\noise\init.lua", "Lua", 7, 0, 0, 0, 0, 0, 7
"c:\Users\haoti\Documents\GitHub\blockgamev2\src\ServerStorage\Deepslate\worldgen\DensityFunction.lua", "Lua", 744, 0, 0, 0, 3, 61, 808
"c:\Users\haoti\Documents\GitHub\blockgamev2\src\ServerStorage\Deepslate\worldgen\NoiseGeneratorSettings.lua", "Lua", 36, 0, 0, 0, 8, 5, 49
"c:\Users\haoti\Documents\GitHub\blockgamev2\src\ServerStorage\Deepslate\worldgen\NoiseParameters.lua", "Lua", 8, 0, 0, 0, 0, 0, 8
"c:\Users\haoti\Documents\GitHub\blockgamev2\src\ServerStorage\Deepslate\worldgen\NoiseRouter.lua", "Lua", 120, 0, 0, 0, 0, 17, 137
"c:\Users\haoti\Documents\GitHub\blockgamev2\src\ServerStorage\Deepslate\worldgen\NoiseSettings.lua", "Lua", 49, 0, 0, 0, 0, 8, 57
"c:\Users\haoti\Documents\GitHub\blockgamev2\src\ServerStorage\Deepslate\worldgen\RandomState.lua", "Lua", 114, 0, 0, 0, 1, 4, 119
"c:\Users\haoti\Documents\GitHub\blockgamev2\src\ServerStorage\Deepslate\worldgen\WorldgenRegistries.lua", "Lua", 30, 0, 0, 0, 0, 0, 30
"c:\Users\haoti\Documents\GitHub\blockgamev2\src\ServerStorage\Deepslate\worldgen\biome\BiomeParser.lua", "Lua", 25, 0, 0, 0, 0, 0, 25
"c:\Users\haoti\Documents\GitHub\blockgamev2\src\ServerStorage\Deepslate\worldgen\biome\Climate.lua", "Lua", 329, 0, 0, 0, 1, 31, 361
"c:\Users\haoti\Documents\GitHub\blockgamev2\src\ServerStorage\Deepslate\worldgen\biome\FeatureParser.lua", "Lua", 78, 0, 0, 0, 18, 2, 98
"c:\Users\haoti\Documents\GitHub\blockgamev2\src\ServerStorage\Deepslate\worldgen\biome\MultiNoiseBiomeSource.lua", "Lua", 29, 0, 0, 0, 0, 2, 31
"c:\Users\haoti\Documents\GitHub\blockgamev2\src\ServerStorage\EntityAttributesCreator.lua", "Lua", 218, 0, 0, 0, 10, 3, 231
"c:\Users\haoti\Documents\GitHub\blockgamev2\src\ServerStorage\GenerationHandler\BiomeHandler.lua", "Lua", 186, 0, 0, 0, 1, 3, 190
"c:\Users\haoti\Documents\GitHub\blockgamev2\src\ServerStorage\GenerationHandler\MultiHandler.lua", "Lua", 29, 0, 0, 0, 0, 0, 29
"c:\Users\haoti\Documents\GitHub\blockgamev2\src\ServerStorage\GenerationHandler\TerrianHandler.lua", "Lua", 631, 0, 0, 0, 25, 23, 679
"c:\Users\haoti\Documents\GitHub\blockgamev2\src\ServerStorage\GenerationHandler\init.lua", "Lua", 262, 0, 0, 0, 5, 12, 279
"c:\Users\haoti\Documents\GitHub\blockgamev2\src\ServerStorage\GenerationMultiHandler.lua", "Lua", 562, 0, 0, 0, 24, 22, 608
"c:\Users\haoti\Documents\GitHub\blockgamev2\src\ServerStorage\PathFinding.lua", "Lua", 253, 0, 0, 0, 26, 13, 292
"c:\Users\haoti\Documents\GitHub\blockgamev2\src\ServerStorage\PlayerControlsHandler.lua", "Lua", 35, 0, 0, 0, 0, 2, 37
"c:\Users\haoti\Documents\GitHub\blockgamev2\src\ServerStorage\ServerStuff\DataHandler.lua", "Lua", 198, 0, 0, 0, 14, 14, 226
"c:\Users\haoti\Documents\GitHub\blockgamev2\src\ServerStorage\ServerStuff\EntityHandler.lua", "Lua", 374, 0, 0, 0, 8, 2, 384
"c:\Users\haoti\Documents\GitHub\blockgamev2\src\ServerStorage\ServerStuff\ServerChunk.lua", "Lua", 259, 0, 0, 0, 16, 5, 280
"c:\Users\haoti\Documents\GitHub\blockgamev2\src\ServerStorage\ServerStuff\SharedService.lua", "Lua", 54, 0, 0, 0, 3, 3, 60
"c:\Users\haoti\Documents\GitHub\blockgamev2\src\ServerStorage\oLDSTUFF\Old.lua", "Lua", 143, 0, 0, 0, 47, 4, 194
"c:\Users\haoti\Documents\GitHub\blockgamev2\src\ServerStorage\oLDSTUFF\ServerChunkOld.lua", "Lua", 351, 0, 0, 0, 16, 14, 381
"c:\Users\haoti\Documents\GitHub\blockgamev2\src\StarterPlayer\StarterPlayerScripts\ClientStuff\ClientChunk.lua", "Lua", 20, 0, 0, 0, 0, 1, 21
"c:\Users\haoti\Documents\GitHub\blockgamev2\src\StarterPlayer\StarterPlayerScripts\Controller.lua", "Lua", 498, 0, 0, 0, 11, 6, 515
"c:\Users\haoti\Documents\GitHub\blockgamev2\src\StarterPlayer\StarterPlayerScripts\PlayerSettings.lua", "Lua", 0, 0, 0, 0, 0, 1, 1
"c:\Users\haoti\Documents\GitHub\blockgamev2\src\StarterPlayer\StarterPlayerScripts\Render\BlockHandler.lua", "Lua", 185, 0, 0, 0, 4, 1, 190
"c:\Users\haoti\Documents\GitHub\blockgamev2\src\StarterPlayer\StarterPlayerScripts\Render\ChunkShared.lua", "Lua", 59, 0, 0, 0, 1, 4, 64
"c:\Users\haoti\Documents\GitHub\blockgamev2\src\StarterPlayer\StarterPlayerScripts\Render\GreedyMesh.lua", "Lua", 203, 0, 0, 0, 3, 0, 206
"c:\Users\haoti\Documents\GitHub\blockgamev2\src\StarterPlayer\StarterPlayerScripts\Render\MultiHandler.lua", "Lua", 120, 0, 0, 0, 12, 9, 141
"c:\Users\haoti\Documents\GitHub\blockgamev2\src\StarterPlayer\StarterPlayerScripts\Render\RenderMultiFunctions.lua", "Lua", 106, 0, 0, 0, 0, 2, 108
"c:\Users\haoti\Documents\GitHub\blockgamev2\src\StarterPlayer\StarterPlayerScripts\Render\init.lua", "Lua", 218, 0, 0, 0, 9, 3, 230
"c:\Users\haoti\Documents\GitHub\blockgamev2\src\StarterPlayer\StarterPlayerScripts\ServerFpsHandler.lua", "Lua", 12, 0, 0, 0, 1, 0, 13
"c:\Users\haoti\Documents\GitHub\blockgamev2\src\StarterPlayer\StarterPlayerScripts\__init__.client.lua", "Lua", 419, 0, 0, 0, 22, 9, 450
"c:\Users\haoti\Documents\GitHub\blockgamev2\src\Workspace\SimplexModule.lua", "Lua", 253, 0, 0, 0, 3, 58, 314
"Total", "-", 23823, 78, 12, 2, 873, 1527, 26315